"aa" = (/turf/simulated/shuttle/wall{icon_state = "wall3"; dir = 1},/area)
"ab" = (/turf/space,/area)
"ac" = (/turf/simulated/wall,/area/discount_dan_base)
"ad" = (/turf/simulated/floor{icon_state = "yellowfull"},/area/discount_dan_base)
"ae" = (/obj/structure/shuttle/engine/heater{icon_state = "heater"; dir = 1},/obj/structure/window/reinforced,/turf/simulated/shuttle/floor{icon = 'icons/turf/floors.dmi'; icon_state = "blueyellowfull"},/area/shuttle/discount/station)
"af" = (/obj/machinery/door/window/brigdoor{base_state = "left"; dir = 4; normalspeed = 0; req_access = null; req_access_txt = "61"; req_one_access_txt = ""},/turf/simulated/floor{icon_state = "yellowfull"},/area/discount_dan_base)
"ag" = (/obj/machinery/door/window/brigdoor{base_state = "left"; dir = 8; icon_state = "rightsecuredeny"; normalspeed = 0; req_access = null; req_access_txt = "61"; req_one_access_txt = ""},/turf/simulated/shuttle/floor{icon = 'icons/turf/floors.dmi'; icon_state = "blueyellowfull"},/area/shuttle/discount/station)
"ah" = (/obj/machinery/light/small{dir = 4; on = 1},/turf/simulated/shuttle/floor{icon = 'icons/turf/floors.dmi'; icon_state = "blueyellowfull"},/area/shuttle/discount/station)
"ai" = (/obj/machinery/door/window/brigdoor{base_state = "left"; dir = 4; icon_state = "rightsecuredeny"; normalspeed = 0; req_access = null; req_access_txt = "61"; req_one_access_txt = ""},/turf/simulated/floor{icon_state = "yellowfull"},/area/discount_dan_base)
"aj" = (/obj/docking_port/destination/discount/station{icon_state = "docking_station"; dir = 4},/obj/machinery/door/airlock/multi_tile/glass{aiControlDisabled = 1; dir = 2; normalspeed = 0},/turf/simulated/floor{icon_state = "yellowfull"},/area/discount_dan_base)
"ak" = (/obj/machinery/door/airlock/multi_tile/glass{aiControlDisabled = 1; dir = 2; normalspeed = 0},/obj/docking_port/shuttle{dir = 8},/turf/simulated/shuttle/floor{icon = 'icons/turf/floors.dmi'; icon_state = "blueyellowfull"},/area/shuttle/discount/station)
"al" = (/obj/machinery/door/window/brigdoor{base_state = "left"; dir = 8; normalspeed = 0; req_access = null; req_access_txt = "61"; req_one_access_txt = ""},/turf/simulated/shuttle/floor{icon = 'icons/turf/floors.dmi'; icon_state = "blueyellowfull"},/area/shuttle/discount/station)
"am" = (/obj/item/trash/discountchocolate,/turf/simulated/shuttle/floor{icon = 'icons/turf/floors.dmi'; icon_state = "blueyellowfull"},/area/shuttle/discount/station)
"an" = (/obj/structure/rack,/obj/item/weapon/tank/emergency_oxygen,/obj/item/clothing/mask/breath,/turf/simulated/shuttle/floor{icon = 'icons/turf/floors.dmi'; icon_state = "blueyellowfull"},/area/shuttle/discount/station)
"ao" = (/obj/item/trash/donitos,/turf/simulated/shuttle/floor{icon = 'icons/turf/floors.dmi'; icon_state = "blueyellowfull"},/area/shuttle/discount/station)
"ap" = (/obj/machinery/light/small,/obj/item/trash/cigbutt,/turf/simulated/shuttle/floor{icon = 'icons/turf/floors.dmi'; icon_state = "blueyellowfull"},/area/shuttle/discount/station)
"aq" = (/obj/effect/landmark{name = "discountstart"},/obj/item/trash/danitos,/turf/simulated/shuttle/floor{icon = 'icons/turf/floors.dmi'; icon_state = "blueyellowfull"},/area/shuttle/discount/station)
"ar" = (/turf/simulated/shuttle/wall{icon_state = "wall3"; dir = 1},/area/discount_dan_base)
"as" = (/obj/structure/table/woodentable,/obj/item/device/radio/intercom/globalcom{name = "Discount Dan Secret Code Conveyance Device"},/turf/simulated/floor{icon_state = "yellowfull"},/area/discount_dan_base)
"at" = (/obj/structure/table/woodentable,/turf/simulated/floor{icon_state = "yellowfull"},/area/discount_dan_base)
"au" = (/obj/structure/bed/chair/folding{dir = 4},/turf/simulated/floor{icon_state = "yellowfull"},/area/discount_dan_base)
"av" = (/mob/living/carbon/monkey{bruteloss = 200; can_stand = 0; canmove = 0; name = "Discount Dan Help Desk Employee"; voice_name = "ook"},/turf/simulated/floor{icon_state = "yellowfull"},/area/discount_dan_base)
"cw" = (/obj/structure/shuttle/engine/propulsion/right{dir = 1},/turf/space,/area/shuttle/discount/station)
"cA" = (/turf/simulated/shuttle/wall{icon_state = "bswall3"},/area/shuttle/discount/station)
"cD" = (/turf/simulated/shuttle/floor{icon = 'icons/turf/floors.dmi'; icon_state = "blueyellowfull"},/area/shuttle/discount/station)
"cE" = (/obj/effect/landmark{name = "discountstart"},/turf/simulated/shuttle/floor{icon = 'icons/turf/floors.dmi'; icon_state = "blueyellowfull"},/area/shuttle/discount/station)
"cF" = (/turf/space,/turf/simulated/shuttle/wall{icon_state = "gwall_space"},/area/shuttle/discount/station)
"cG" = (/turf/simulated/shuttle/wall{icon_state = "bswallc1"},/area/shuttle/discount/station)
"cH" = (/turf/simulated/shuttle/wall{icon_state = "bswallc2"},/area/shuttle/discount/station)
"cI" = (/turf/space,/turf/simulated/shuttle/wall{dir = 4; icon_state = "diagonalWall3"},/area/shuttle/discount/station)
"dy" = (/obj/structure/grille,/obj/structure/window/reinforced{dir = 8},/obj/structure/window/reinforced,/obj/structure/window/reinforced{dir = 1},/obj/structure/window/reinforced{dir = 4},/obj/structure/window/full/reinforced,/turf/simulated/shuttle/plating,/area/shuttle/discount/station)
"dC" = (/obj/machinery/computer/shuttle_control/discount,/turf/simulated/shuttle/floor{icon = 'icons/turf/floors.dmi'; icon_state = "blueyellowfull"},/area/shuttle/discount/station)

(1,1,1) = {"
aaaaaaaaaaaaaaaaaaaaaaaaaaaaaaaaaaaaaaaaaaaaaaaaaaaaaaaaaaaaaaaaaaaaaaaaaaaaaa
aaababababababababababababababababababababababababababacacacacacaccwcwcwcwcwaa
aaababababababababababababababababababababababababababacadadadadaccAaeaeaecAaa
aaababababababababababababababababababababababababababacadadadafadcDagcDahcAaa
aaababababababababababababababababababababababababababacadadadaiajakalcEamcAaa
aaababababababababababababababababababababababababababacadadadadaccAcDcEcDcAaa
aaababababababababababababababababababababababababababacadadadadaccAcDcEancAaa
aaababababababababababababababababababababababababababacadadadadaccAaocEancAaa
aaababababababababababababababababababababababababababacacacacacaccAcDcEcDcAaa
aaababababababababababababababababababababababababababacadadadadaccAapaqcDcAaa
aaababababababababababababababababababababababababababacadadadadaccFcGdCcHcIaa
aaababababababababababababababababababababababababababacadadadadacabcFdycIabaa
aaababababababababababababababababababababababababababacadadadadacarararararaa
aaababababababababababababababababababababababababababacadadadadacarasatadadaa
aaababababababababababababababababababababababababababacadadadadacaradauadadaa
aaababababababababababababababababababababababababababacadadadadacaradadavadaa
aaababababababababababababababababababababababababababacacacacacacarararararaa
aaabababababababababababababababababababababababababababababababababababababaa
aaabababababababababababababababababababababababababababababababababababababaa
aaabababababababababababababababababababababababababababababababababababababaa
aaabababababababababababababababababababababababababababababababababababababaa
aaabababababababababababababababababababababababababababababababababababababaa
aaabababababababababababababababababababababababababababababababababababababaa
aaabababababababababababababababababababababababababababababababababababababaa
aaabababababababababababababababababababababababababababababababababababababaa
aaabababababababababababababababababababababababababababababababababababababaa
aaabababababababababababababababababababababababababababababababababababababaa
aaabababababababababababababababababababababababababababababababababababababaa
aaabababababababababababababababababababababababababababababababababababababaa
aaabababababababababababababababababababababababababababababababababababababaa
aaabababababababababababababababababababababababababababababababababababababaa
aaabababababababababababababababababababababababababababababababababababababaa
aaabababababababababababababababababababababababababababababababababababababaa
aaabababababababababababababababababababababababababababababababababababababaa
aaabababababababababababababababababababababababababababababababababababababaa
aaabababababababababababababababababababababababababababababababababababababaa
aaaaaaaaaaaaaaaaaaaaaaaaaaaaaaaaaaaaaaaaaaaaaaaaaaaaaaaaaaaaaaaaaaaaaaaaaaaaaa
"}
